wwwwwwwwwwwwwwwwwwwwwwwwwwwwwwwwwwwwwwwwwwwwww----w
w-------------------------------------------------w
w-------------------------------------------------w
w-----------------------------------pzzzzzzzzzzzzqw
wpzzzq-----------------------T--------------------w
w---------------pzzzzzzq--------------------------w
w-------------------------------------------------w
w-------------------------------------------------w
w-------------------------------------------------w
w-------------------------------------------------w
w--------pzzzzq-----------------------------------w
w-------------------------------------------------w
w----T----------------pzzzzzzq--------------------w
w-----------------------------------pzzzzzzzzzzzzzw
w---------T-----------------------------------J--Lw
w---------------------------------------------J--Lw
w----T----------------------------------------J--Lw
w---------------------------------------------J--Lw
w--------T------------------------------------J--Lw
w------------------------pzzzzzzzzq-----------J--Lw
w---$-----------------oooooooooo-----------------Lw
w------------------------------------------------Lw
w----TTTTTTTTTTTTTTTTTTTTTTTTTTTTTTTTTTTTTTTTTTTTTw
w----wwwwwwwwwwwwwwwwwwwwwwwwwwwwwwwwwwwwwwwwwwwwww
;m