3wwwwwwwwwwwwwwwwwwwwwwwwwwwwwwwwwwwwwwwwwwwww----w
w-------------------------------------------------&
w-------------------------------------------Y-----w
w-y--------68888888888888889---------------C------w
wpzzzq------------------------------pzzzzzzzzzzzzqw
w-------------------c--------T--------------------w
w---------------pzzzzzzq--------------------------w
w-------------------------------------------------w
w-------------------------------------------------w
w-n-------c---------------------------------------w
w--------pzzzzq-----------------------------------w
w------------------------c------------------------w
w----T----------------pzzzzzzq----------c--C-c----w
w-----------------------------------pzzzzzzzzzzzzzw
w--n------T-----------------------------------J--Lw
w---------------------------------------------J--Lw
w----T----------------------------------------J--Lw
w---------------------------------------------J--Lw
w--------T--------------------Y---------------J--Lw
w------------------------pzzzzzzzzq-----------J--Lw
w---------------------oooooooooo--------N--------Lw
w--------$------c-------------C---&--------------Lw
w----MMMMMMMMMMMMMMMMMMMMMMMMMMMMMMMMMMMMMMMMMMMMMw
w----wwwwwwwwwwwwwwwwwwwwwwwwwwwwwwwwwwwwwwwwwwwwww
;