Bcccccccccccccccccccccccccccccccccccccccccccccccccc
H-------------------------------------------------h
H-------------------------------------------------h
H-------------------------------------------------h
H-------------------------------------------------h
H-------------------------------------------------h
H-------------------------------------------------h
H-----N--------------------------------------m----h
H---pzzzzzq---------------------------------------h
H-------------------------------------------------h
H-------------------------------------------------h
H---------------------pzzzzzzzq-------------------h
H-------------------------------------------------h
H-------------------------------------------------h
H-------------------------------------------------h
H---------------Y---------------------------------h
H------------pzzzzzzq-----------------------------h
H-------------------------------------------------h
H-------------------------------------------------h
H---pzzzq-----------------------------------------h
H---$------------------C--------------------------h
MMMMMMMMMMMMMMMMMMMMMMMMMMMMMMMMMMMMMMMM----------h
wwwwwwwwwwwwwwwwwwwwwwwwwwwwwwwwwwwwwwww----------h
wwwwwwwwwwwwwwwwwwwwwwwwwwwwwwwwwwwwwwww----------h
;                                                                                                q