w-------wwwwwwwwwwwwwwwwwwwwwwwwwwwwwwwwwwwwwwwwwwwwwwwwwwww
w----------------------------------------------------------w
w----------------------------------------------------------w
w----------------------------------------------------------w
w----------------------------------------------------------w
w----------------------------------------------------------w
w----------------------------------------------------------w
w---------------------------------------------------pzzzzzzw
wzzq-----------------------------------------T-------------w
w----------------------------------------------------------w
w---------------------------------------T------------------w
w----T-----------------------------------------------------w
w--------TT------------------------------------------------w
w-------------------------------------------T-------pzzzzzzw
w---------------pzzzzzq------------------------------------w
w--------------------------------------T-------------------w
w----------------------------------------------------------w
w----------------------------------------------------------w-
w------pzzzzzq-------------pzzzzzq-------------------------w
w----------------------------------------------------------w
w----------------------------------------------------------w
wzzzzzzzzzzzzzzzzzzzzzzzzzzzzzzzzzzzzzzzzzzzzq-------------w
w----------------------------------------------------------w
w----------------------------------------------------------w
w------------------------------------------------------pzzzw
w----------------------------------------------------------w
w-------------------------------------------------TT-------w
w----------------------------------------------------------w
w----------------------------------------------TT----------w
wzzzzzzzzq-------------------------------------------------w
w--------------------------------------------T-------------w
w----------------------------------------------------------w
w------------pzzzzzzq---------------------TT---------------w
w----------------------------------------------------------w
w----------------------------------------------------------w
w---------------------------pzzzzzzzzzzq-------------------w
w----------------------------------------------------------w-
w----------------------------------------------------------w
w----------------------------------------------------------w
w----------------------------------------------------------w
w----------------------------------------------------------w
w----------------------------------------------------------w
w---------------pzzzzzzzzzzzzzzzq--------------------------w
w----------------------------------------------------------w
w----------------------------------------pzzzzzzzzzzzzzzzzqw
w----------------------------------------------------------w
w----------------------------------------------------------w
w----------------------------------------------------------w
w----------------------------------------------------------w
w----------------------------------------------------------w
w-------------------------------pzq------------------------w
w-----------------------------pzzzzq-----------------------w
w----------------------------------------------------------w
w----------------------------------------------------------w
w----------------------------------------------------------w
w---------------pzzzzzzq--------------------------pzzzzzzzqw
w----------------------------------------------------------w
w----------------------------------------------------------w
w----TTTTTTTTTTTTTTTTTTTTTTTTTTTTTTTTTTTTTTTTTTTTTTTTTTTTTTw
w----wwwwwwwwwwwwwwwwwwwwwwwwwwwwwwwwwwwwwwwwwwwwwwwwwwwwwww
;